0__________________0
|    | E           |
| L  0__ __0   GH  |
|    |     |       |
|    | CI  |       |
|_  _0___0_0 00    |
|        |    |    |
|     BB |____0__ _|
|__  ____|         |
|        |    BB   |
|    F        BB   |
0________|_________0