24
12
O**********************O
|        x             |
|                      |
|      O**O            |
|         C            |
|    H     $         @ |
|               A      |
|      H               |
|         X            |
|           M          |
|                      |
O**********************O